56 55 55 55 55 58 58 58 58 58 58 58 65 65 63 64  52 52 52 52 21 23 21 1  1  1  1  1  1  1  1  1
51 2  2  2  2  22 22 22 22 22 22 16 9  9  9	 9   1  1  1  7  21 23 21 1  1  1  1  1  1  1  1  1
51 2  2  2  55 20 23 23 23 23 23 21 10 9  10 9   1  5  1  1  21 23 21 1  1  1  1  1  1  1  1  1
51 2  2  2  55 20 23 23 23 23 23 21 13 14 9  10  1  1  1  1  21 23 21 1  1  1  1  1  1  1  1  1
51 2  2  2  55 20 23 23 23 23 23 21 10 10 9  5   1  1  4  1  21 23 21 1  1  1  1  1  1  1  1  1
51 2  2  2  55 20 23 23 23 23 23 21 13 9  10 9   1  1  1  1  21 23 21 1  1  1  1  1  1  1  1  1
56 2  2  2  55 20 23 23 23 23 23 21 9  14 14 9   1  53 1  1  21 23 21 1  1  1  1  1  1  1  1  1
51 2  2  2  55 20 23 23 23 23 23 21 9  12 10 10  1  52 1  1  21 23 21 1  1  1  1  1  1  1  1  1
51 2  2  2  55 20 23 23 23 23 23 21 9  14 9  10  1  1  1  21 23 21 1  1  1  1  1  1  1  1  1  1
51 2  2  2  55 20 23 23 23 23 23 21 10 10 9  9   1  4  5  1  21 23 21 1  1  1  1  1  1  1  1  1
51 54 2  2  55 20 23 23 23 23 23 23 22 22 22 22  22 22 22 22 23 23 21 1  1  1  1  1  1  1  1  1
51 54 54 54 55 20 23 23 23 23 23 23 23 23 23 23  23 23 23 23 23 23 21 1  1  1  1  1  1  1  1  1
56 55 55 55 55 17 19 19 19 19 19 19 19 19 19 19  19 19 19 19 23 23 21 1  1  1  1  1  1  1  1  1
56 9  67 68 10 14 9  10 14 10 10 1  1  1  9  9   1  1  1  1  20 23 21 1  1  1  1  1  1  1  1  1
56 9  10 11 9  64 10 11 53 13 14 9  9  1  1  9   1  1  1  1  20 23 21 1  1  1  1  1  1  1  1  1
56 13 12 10 9  10 10 14 52 9  10 9  1  9  9  1   1  1  1  1  20 23 21 1  1  1  1  1  1  1  1  1

56 1 1 1 1 1 1 1 1 1 1 1 1 1 1 1  1 1 1 1 1 1 1 1 1 1 1 1 1 1 1 1
56 1 1 1 1 1 1 1 1 1 1 1 1 1 1 1  1 1 1 1 1 1 1 1 1 1 1 1 1 1 1 1
56 1 1 1 1 1 1 1 1 1 1 1 1 1 1 1  1 1 1 1 1 1 1 1 1 1 1 1 1 1 1 1
56 1 1 1 1 1 1 1 1 1 1 1 1 1 1 1  1 1 1 1 1 1 1 1 1 1 1 1 1 1 1 1
56 1 1 1 1 1 1 1 1 1 1 1 1 1 1 1  1 1 1 1 1 1 1 1 1 1 1 1 1 1 1 1
56 1 1 1 1 1 1 1 1 1 1 1 1 1 1 1  1 1 1 1 1 1 1 1 1 1 1 1 1 1 1 1
56 1 1 1 1 1 1 1 1 1 1 1 1 1 1 1  1 1 1 1 1 1 1 1 1 1 1 1 1 1 1 1
56 1 1 1 1 1 1 1 1 1 1 1 1 1 1 1  1 1 1 1 1 1 1 1 1 1 1 1 1 1 1 1
56 1 1 1 1 1 1 1 1 1 1 1 1 1 1 1  1 1 1 1 1 1 1 1 1 1 1 1 1 1 1 1
56 1 1 1 1 1 1 1 1 1 1 1 1 1 1 1  1 1 1 1 1 1 1 1 1 1 1 1 1 1 1 1
56 1 1 1 1 1 1 1 1 1 1 1 1 1 1 1  1 1 1 1 1 1 1 1 1 1 1 1 1 1 1 1
56 1 1 1 1 1 1 1 1 1 1 1 1 1 1 1  1 1 1 1 1 1 1 1 1 1 1 1 1 1 1 1
56 1 1 1 1 1 1 1 1 1 1 1 1 1 1 1  1 1 1 1 1 1 1 1 1 1 1 1 1 1 1 1
56 1 1 1 1 1 1 1 1 1 1 1 1 1 1 1  1 1 1 1 1 1 1 1 1 1 1 1 1 1 1 1
56 1 1 1 1 1 1 1 1 1 1 1 1 1 1 1  1 1 1 1 1 1 1 1 1 1 1 1 1 1 1 1
56 1 1 1 1 1 1 1 1 1 1 1 1 1 1 1  1 1 1 1 1 1 1 1 1 1 1 1 1 1 1 1