56 55 55 55 55 58 58 58 58 58 58 58 52 52 52 52  52 52 52 52 21 23 21 1  1  1  1  1  1  1  1  1
51 2  2  2  2  22 22 22 22 22 22 16 1  53 1	 1   1  1  1  7  21 23 21 1  1  1  1  1  1  1  1  1
51 2  2  2  55 20 23 23 23 23 23 21 1  52 1  1   1  5  1  1  21 23 21 1  1  1  1  1  1  1  1  1
51 2  2  2  55 20 23 23 23 23 23 21 1  1  1  1   1  1  1  1  21 23 21 1  1  1  1  1  1  1  1  1
51 2  2  2  55 20 23 23 23 23 23 21 1  1  1  5   1  1  4  1  21 23 21 1  1  1  1  1  1  1  1  1
51 2  2  2  55 20 23 23 23 23 23 21 5  4  1  1   1  1  1  1  21 23 21 1  1  1  1  1  1  1  1  1
56 2  2  2  55 20 23 23 23 23 23 21 1  4  1  1   1  53 1  1  21 23 21 1  1  1  1  1  1  1  1  1
51 2  2  2  55 20 23 23 23 23 23 21 53 1  1  1   1  52 1  1  21 23 21 1  1  1  1  1  1  1  1  1
51 2  2  2  55 20 23 23 23 23 23 21 52 5  53 1   1  1  1  1  21 23 21 1  1  1  1  1  1  1  1  1
51 2  2  2  55 20 23 23 23 23 23 21 1  1  52 1   1  4  5  1  21 23 21 1  1  1  1  1  1  1  1  1
51 54 2  2  55 20 23 23 23 23 23 23 22 22 22 22  22 22 22 22 23 23 21 1  1  1  1  1  1  1  1  1
51 54 54 54 55 20 23 23 23 23 23 23 23 23 23 23  23 23 23 23 23 23 21 1  1  1  1  1  1  1  1  1
56 55 55 55 55 17 19 19 19 19 19 19 19 19 19 19  19 19 19 19 23 23 21 1  1  1  1  1  1  1  1  1
56 9  9  10 1  5  1  1  1  1  1  1  1  1  1  1   1  1  1  1  20 23 21 1  1  1  1  1  1  1  1  1
56 9  10 11 1  1  1  1  53  1  4  1  1  1  1  1   1  1  1  1  20 23 21 1  1  1  1  1  1  1  1  1
56 13 12 1 1  1  1  5  52  1  1  1  1  1  1  1   1  1  1  1  20 23 21 1  1  1  1  1  1  1  1  1

56 1 1 1 1 1 1 1 1 1 1 1 1 1 1 1  1 1 1 1 1 1 1 1 1 1 1 1 1 1 1 1
56 1 1 1 1 1 1 1 1 1 1 1 1 1 1 1  1 1 1 1 1 1 1 1 1 1 1 1 1 1 1 1
56 1 1 1 1 1 1 1 1 1 1 1 1 1 1 1  1 1 1 1 1 1 1 1 1 1 1 1 1 1 1 1
56 1 1 1 1 1 1 1 1 1 1 1 1 1 1 1  1 1 1 1 1 1 1 1 1 1 1 1 1 1 1 1
56 1 1 1 1 1 1 1 1 1 1 1 1 1 1 1  1 1 1 1 1 1 1 1 1 1 1 1 1 1 1 1
56 1 1 1 1 1 1 1 1 1 1 1 1 1 1 1  1 1 1 1 1 1 1 1 1 1 1 1 1 1 1 1
56 1 1 1 1 1 1 1 1 1 1 1 1 1 1 1  1 1 1 1 1 1 1 1 1 1 1 1 1 1 1 1
56 1 1 1 1 1 1 1 1 1 1 1 1 1 1 1  1 1 1 1 1 1 1 1 1 1 1 1 1 1 1 1
56 1 1 1 1 1 1 1 1 1 1 1 1 1 1 1  1 1 1 1 1 1 1 1 1 1 1 1 1 1 1 1
56 1 1 1 1 1 1 1 1 1 1 1 1 1 1 1  1 1 1 1 1 1 1 1 1 1 1 1 1 1 1 1
56 1 1 1 1 1 1 1 1 1 1 1 1 1 1 1  1 1 1 1 1 1 1 1 1 1 1 1 1 1 1 1
56 1 1 1 1 1 1 1 1 1 1 1 1 1 1 1  1 1 1 1 1 1 1 1 1 1 1 1 1 1 1 1
56 1 1 1 1 1 1 1 1 1 1 1 1 1 1 1  1 1 1 1 1 1 1 1 1 1 1 1 1 1 1 1
56 1 1 1 1 1 1 1 1 1 1 1 1 1 1 1  1 1 1 1 1 1 1 1 1 1 1 1 1 1 1 1
56 1 1 1 1 1 1 1 1 1 1 1 1 1 1 1  1 1 1 1 1 1 1 1 1 1 1 1 1 1 1 1
56 1 1 1 1 1 1 1 1 1 1 1 1 1 1 1  1 1 1 1 1 1 1 1 1 1 1 1 1 1 1 1