56 55 55 55 55 58 58 58 58 58 58 58 52 52 52 52  52 52 52 52 7 7 7 1 1 1 1 1 1 1 1 1
51 2  2  2  2  7  7  7  7  57 57 57 5  1  53 1	 1 1 1 1 7 7 7 1 1 1 1 1 1 1 1 1	
51 2  2  2  55 7  7  7  7  7  7  7  1  1  52 1   1 5 1 1 7 7 7 1 1 1 1 1 1 1 1 1
51 2  2  2  55 7  7  7  7  8  7  7  1  1  1  1   1 1 1 1 7 7 7 1 1 1 1 1 1 1 1 1
51 2  2  2  55 7  7  7  7  7  60 59 1  1  1  5   1 1 4 1 7 7 7 1 1 1 1 1 1 1 1 1
51 2  2  2  55 7  7  7  7  7  7  7  5  4  1  1   1 1 1 1 7 7 7 1 1 1 1 1 1 1 1 1
56 2  2  2  55 7  7  7  7  7  62 61 1  4  1  1   1 53 1 1 7 7 7 1 1 1 1 1 1 1 1 1
51 2  2  2  55 7  7  7  7  8  7  7  53 1  1  1   1 52 1 1 7 7 7 1 1 1 1 1 1 1 1 1
51 2  2  2  55 7  7  7  7  7  7  7  52 5  53 1   1 1 1 1 7 7 7 1 1 1 1 1 1 1 1 1
51 2  2  2  55 7  7  7  7  7  7  7  1  1  52 1   1 4 5 1 7 7 7 1 1 1 1 1 1 1 1 1
51 54 2  2  55 7  7  7  7  7  7  7  7  7  7  7   7 7 7 7 7 7 7 1 1 1 1 1 1 1 1 1
51 54 54 54 55 7  7  7  7  7  7  7  7  7  7  7   7 7 7 7 7 7 7 1 1 1 1 1 1 1 1 1
56 55 55 55 55 7  7  7  7  7  7  7  7  7  7  7   7 7 7 7 7 7 7 1 1 1 1 1 1 1 1 1
56 1  1  1  1  5  1  1  1  1  1  1  1  1  1  1   1 1 1 1 7 7 7 1 1 1 1 1 1 1 1 1
56 5  53 1 1  1  1  1  53  1  4  1  1  1  1  1   1 1 1 1 7 7 7 1 1 1 1 1 1 1 1 1
56 1  52 1 1  1  1  5  52  1  1  1  1  1  1  1   1 1 1 1 7 7 7 1 1 1 1 1 1 1 1 1

56 1 1 1 1 1 1 1 1 1 1 1 1 1 1 1  1 1 1 1 1 1 1 1 1 1 1 1 1 1 1 1
56 1 1 1 1 1 1 1 1 1 1 1 1 1 1 1  1 1 1 1 1 1 1 1 1 1 1 1 1 1 1 1
56 1 1 1 1 1 1 1 1 1 1 1 1 1 1 1  1 1 1 1 1 1 1 1 1 1 1 1 1 1 1 1
56 1 1 1 1 1 1 1 1 1 1 1 1 1 1 1  1 1 1 1 1 1 1 1 1 1 1 1 1 1 1 1
56 1 1 1 1 1 1 1 1 1 1 1 1 1 1 1  1 1 1 1 1 1 1 1 1 1 1 1 1 1 1 1
56 1 1 1 1 1 1 1 1 1 1 1 1 1 1 1  1 1 1 1 1 1 1 1 1 1 1 1 1 1 1 1
56 1 1 1 1 1 1 1 1 1 1 1 1 1 1 1  1 1 1 1 1 1 1 1 1 1 1 1 1 1 1 1
56 1 1 1 1 1 1 1 1 1 1 1 1 1 1 1  1 1 1 1 1 1 1 1 1 1 1 1 1 1 1 1
56 1 1 1 1 1 1 1 1 1 1 1 1 1 1 1  1 1 1 1 1 1 1 1 1 1 1 1 1 1 1 1
56 1 1 1 1 1 1 1 1 1 1 1 1 1 1 1  1 1 1 1 1 1 1 1 1 1 1 1 1 1 1 1
56 1 1 1 1 1 1 1 1 1 1 1 1 1 1 1  1 1 1 1 1 1 1 1 1 1 1 1 1 1 1 1
56 1 1 1 1 1 1 1 1 1 1 1 1 1 1 1  1 1 1 1 1 1 1 1 1 1 1 1 1 1 1 1
56 1 1 1 1 1 1 1 1 1 1 1 1 1 1 1  1 1 1 1 1 1 1 1 1 1 1 1 1 1 1 1
56 1 1 1 1 1 1 1 1 1 1 1 1 1 1 1  1 1 1 1 1 1 1 1 1 1 1 1 1 1 1 1
56 1 1 1 1 1 1 1 1 1 1 1 1 1 1 1  1 1 1 1 1 1 1 1 1 1 1 1 1 1 1 1
56 1 1 1 1 1 1 1 1 1 1 1 1 1 1 1  1 1 1 1 1 1 1 1 1 1 1 1 1 1 1 1